YOTTAVOLT	YV	SI.VOLT
ZETTAVOLT	ZV	SI.VOLT
EXAVOLT	EV	SI.VOLT
PETAVOLT	PV	SI.VOLT
TERAVOLT	TV	SI.VOLT
GIGAVOLT	GV	SI.VOLT
MEGAVOLT	MV	SI.VOLT
KILOVOLT	kV	SI.VOLT
HECTOVOLT	hV	SI.VOLT
DECAVOLT	daV	SI.VOLT
VOLT	V	SI.VOLT
DECIVOLT	dV	SI.VOLT
CENTIVOLT	cV	SI.VOLT
MILLIVOLT	mV	SI.VOLT
MICROVOLT	ÂµV	SI.VOLT
NANOVOLT	nV	SI.VOLT
PICOVOLT	pV	SI.VOLT
FEMTOVOLT	fV	SI.VOLT
ATTOVOLT	aV	SI.VOLT
ZEPTOVOLT	zV	SI.VOLT
YOCTOVOLT	yV	SI.VOLT