YOTTAHERTZ	YHz	SI.HERTZ
ZETTAHERTZ	ZHz	SI.HERTZ
EXAHERTZ	EHz	SI.HERTZ
PETAHERTZ	PHz	SI.HERTZ
TERAHERTZ	THz	SI.HERTZ
GIGAHERTZ	GHz	SI.HERTZ
MEGAHERTZ	MHz	SI.HERTZ
KILOHERTZ	kHz	SI.HERTZ
HECTOHERTZ	hHz	SI.HERTZ
DECAHERTZ	daHz	SI.HERTZ
HERTZ	Hz	SI.HERTZ
DECIHERTZ	dHz	SI.HERTZ
CENTIHERTZ	cHz	SI.HERTZ
MILLIHERTZ	mHz	SI.HERTZ
MICROHERTZ	ÂµHz	SI.HERTZ
NANOHERTZ	nHz	SI.HERTZ
PICOHERTZ	pHz	SI.HERTZ
FEMTOHERTZ	fHz	SI.HERTZ
ATTOHERTZ	aHz	SI.HERTZ
ZEPTOHERTZ	zHz	SI.HERTZ
YOCTOHERTZ	yHz	SI.HERTZ