YOTTAMETER	Ym	SI.METRE
ZETTAMETER	Zm	SI.METRE
EXAMETER	Em	SI.METRE
PETAMETER	Pm	SI.METRE
TERAMETER	Tm	SI.METRE
GIGAMETER	Gm	SI.METRE
MEGAMETER	Mm	SI.METRE
KILOMETER	km	SI.METRE
HECTOMETER	hm	SI.METRE
DECAMETER	dam	SI.METRE
METER	m	SI.METRE
DECIMETER	dm	SI.METRE
CENTIMETER	cm	SI.METRE
MILLIMETER	mm	SI.METRE
MICROMETER	µm	SI.METRE
NANOMETER	nm	SI.METRE
PICOMETER	pm	SI.METRE
FEMTOMETER	fm	SI.METRE
ATTOMETER	am	SI.METRE
ZEPTOMETER	zm	SI.METRE
YOCTOMETER	ym	SI.METRE
ANGSTROM	Å	SI.METRE
ASTRONOMICALUNIT	ua	SI.METRE
LIGHTYEAR	ly	SI.METRE
PARSEC	pc	SI.METRE
THOU	thou	Imperial.INCH
LINE	li	Imperial.INCH
INCH	in	Imperial.INCH
FOOT	ft	Imperial.INCH
YARD	yd	Imperial.INCH
MILE	mi	Imperial.INCH
POINT	pt	Imperial.INCH
PIXEL	pixel	Pixel
REFERENCEFRAME	reference frame	ReferenceFrame