YOTTAWATT	YW	SI.WATT
ZETTAWATT	ZW	SI.WATT
EXAWATT	EW	SI.WATT
PETAWATT	PW	SI.WATT
TERAWATT	TW	SI.WATT
GIGAWATT	GW	SI.WATT
MEGAWATT	MW	SI.WATT
KILOWATT	kW	SI.WATT
HECTOWATT	hW	SI.WATT
DECAWATT	daW	SI.WATT
WATT	W	SI.WATT
DECIWATT	dW	SI.WATT
CENTIWATT	cW	SI.WATT
MILLIWATT	mW	SI.WATT
MICROWATT	ÂµW	SI.WATT
NANOWATT	nW	SI.WATT
PICOWATT	pW	SI.WATT
FEMTOWATT	fW	SI.WATT
ATTOWATT	aW	SI.WATT
ZEPTOWATT	zW	SI.WATT
YOCTOWATT	yW	SI.WATT