YOTTAPASCAL	YPa	SI.PASCAL
ZETTAPASCAL	ZPa	SI.PASCAL
EXAPASCAL	EPa	SI.PASCAL
PETAPASCAL	PPa	SI.PASCAL
TERAPASCAL	TPa	SI.PASCAL
GIGAPASCAL	GPa	SI.PASCAL
MEGAPASCAL	MPa	SI.PASCAL
KILOPASCAL	kPa	SI.PASCAL
HECTOPASCAL	hPa	SI.PASCAL
DECAPASCAL	daPa	SI.PASCAL
PASCAL	Pa	SI.PASCAL
DECIPASCAL	dPa	SI.PASCAL
CENTIPASCAL	cPa	SI.PASCAL
MILLIPASCAL	mPa	SI.PASCAL
MICROPASCAL	ÂµPa	SI.PASCAL
NANOPASCAL	nPa	SI.PASCAL
PICOPASCAL	pPa	SI.PASCAL
FEMTOPASCAL	fPa	SI.PASCAL
ATTOPASCAL	aPa	SI.PASCAL
ZEPTOPASCAL	zPa	SI.PASCAL
YOCTOPASCAL	yPa	SI.PASCAL
BAR	bar	SI.PASCAL
MEGABAR	Mbar	SI.PASCAL
KILOBAR	kbar	SI.PASCAL
DECIBAR	dbar	SI.PASCAL
CENTIBAR	cbar	SI.PASCAL
MILLIBAR	mbar	SI.PASCAL
ATMOSPHERE	atm	SI.PASCAL
PSI	psi	SI.PASCAL
TORR	Torr	SI.PASCAL
MILLITORR	mTorr	SI.PASCAL
MMHG	mm Hg	SI.PASCAL