YOTTASECOND	Ys	SI.SECOND
ZETTASECOND	Zs	SI.SECOND
EXASECOND	Es	SI.SECOND
PETASECOND	Ps	SI.SECOND
TERASECOND	Ts	SI.SECOND
GIGASECOND	Gs	SI.SECOND
MEGASECOND	Ms	SI.SECOND
KILOSECOND	ks	SI.SECOND
HECTOSECOND	hs	SI.SECOND
DECASECOND	das	SI.SECOND
SECOND	s	SI.SECOND
DECISECOND	ds	SI.SECOND
CENTISECOND	cs	SI.SECOND
MILLISECOND	ms	SI.SECOND
MICROSECOND	Âµs	SI.SECOND
NANOSECOND	ns	SI.SECOND
PICOSECOND	ps	SI.SECOND
FEMTOSECOND	fs	SI.SECOND
ATTOSECOND	as	SI.SECOND
ZEPTOSECOND	zs	SI.SECOND
YOCTOSECOND	ys	SI.SECOND
MINUTE	min	SI.SECOND
HOUR	h	SI.SECOND
DAY	d	SI.SECOND